{
  "rooms": [
    {
      "id": 0,
      "exit_mask": 6,
      "grid": [
        "####..##########",
        "#..............#",
        "#..............#",
        "#....##........#",
        "#..............#",
        "#..............#",
        "#..............D",
        "#..............D",
        "#..............#",
        "#......##......#",
        "#..............#",
        "#..............#",
        "#..............#",
        "####..##########"
      ],
      "spawns": [
        {"type": 1, "x": 160, "y": 120, "param": 0},
        {"type": 0, "x": 0, "y": 0, "param": 0}
      ]
    },
    {
      "id": 1,
      "exit_mask": 12,
      "grid": [
        "##########..####",
        "#..............#",
        "#....##........#",
        "#..............#",
        "#..............#",
        "#..............#",
        "D..............#",
        "D......##......#",
        "#..............#",
        "#..............#",
        "#..............#",
        "#....##........#",
        "#..............#",
        "######..########"
      ],
      "spawns": [
        {"type": 1, "x": 72, "y": 88, "param": 0},
        {"type": 3, "x": 168, "y": 152, "param": 0}
      ]
    },
    {
      "id": 2,
      "exit_mask": 3,
      "grid": [
        "####..##########",
        "#..............#",
        "#......##......#",
        "#..............#",
        "#..............#",
        "#..............#",
        "#..............D",
        "#..............D",
        "#..............#",
        "#..............#",
        "#......##......#",
        "#..............#",
        "#..............#",
        "################"
      ],
      "spawns": [
        {"type": 2, "x": 160, "y": 104, "param": 0},
        {"type": 0, "x": 0, "y": 0, "param": 0}
      ]
    },
    {
      "id": 3,
      "exit_mask": 9,
      "grid": [
        "##########..####",
        "#..............#",
        "#..............#",
        "#....######....#",
        "#..............#",
        "#..............#",
        "D..............#",
        "D......##......#",
        "#..............#",
        "#..............#",
        "#....######....#",
        "#..............#",
        "#..............#",
        "################"
      ],
      "spawns": [
        {"type": 2, "x": 80, "y": 88, "param": 0},
        {"type": 3, "x": 168, "y": 152, "param": 1}
      ]
    }
  ]
}
